Humans: 100
RRRRRRRRRRRRRRRRRRRRRRRRRRRRRRRRRRRRRRRRRRRRRRRRRRRRRRRRRRRRRRRRRRRRRRRRRRRRRRRRRRRRRRRRRRRRRRRRRRRRRRRRRRRRRRRR
R..............................................................................................................R
R.@.....GGGGG............Z....Z...Z...Z...Z...Z...Z...Z...Z...Z...Z...Z..Z...Z...Z.............................R
R........G.G...................................................................................................R
R........G.G.......RRRRRRRRRRR.........RRRRRRRRRR...........RRRRRRRRRRR...........RRRRRRRRRRR..................R
R.......GGGGG......R.........R.........R........L...........L.........R...........R.........R..................R
R..................R....RRRRRR.........R..............................R...........RRRRRR....R..................R
R..................R....R..............R..............................R................R....R..................R
R..................L....L..............LLLLLLLLLLLLLLLLLLLLLLLLLLLLLLLL................L....L..................R
R..................L....L..............................................................L....L..................R
R....................................................G.........................................................R
R....................................................G.........................................................R
R..................GGGGGGGGGGGGGGGGGGGGGGGGGGGGGGGGGGGGGGGGGGGGGGGGGGGGGGGGGGGGGGGGGGGGGGGGG...................R
R....................................................G..........Z....Z....Z....Z....Z....Z....Z....Z...Z...Z...R
R....................................................G.........................................................R
R..............................................................................................................R
R..............................................................................................................R
R..............................................................................................................R
R..............................................................................................................R
R..............................................................................................................R
R.............RRRR.....R.......R...........R.......R............R.......R............R....R...RRRR.............R
R..........RRR...R.....R.......R...........R.......R............R.......R............R....R...R...RRR..........R
R.......RRR......L.....R.......R....RRRR...R.......R....RRRR....R.......R....RRRR....R....R...L......RRR.......R
RRRRRRRRR........R.....R.......R...........R.......R............R.......R............R....R...R.......RRRRRRRRRR
R................R.....RRRRRRRRR...........RRRRRRRRR............RRRRRRRRR............RRRRRR...R................R
R.....................................................................Z......Z.......Z.........................R
R..............................................................................................................R
R..............................................................................................................R
R..........................................................................................................Z...R
R..............................................................................................................R
RRRRRRRRRRRRRRRRRRRRRRRRRRRRRRRRRRRRRRRRRRRRRRRRRRRRRRRRRRRRRRRRRRRRRRRRRRRRRRRRRRRRRRRRRRRRRRRRRRRRRRRRRRRRRRRR